Delirium
An Interactive Fiction by Steven Hack and Rhys Larkins
Release 1 / Serial number 130306 / Inform 7 build 6G60 (I6/v6.32 lib 6/12N) SD

Your bedroom
You can see a rifle and a textbook here.

>take gun
You try taking the rifle, but as you approach it you instead find yourself falling...

You are cramped into a tight, dark space with metal surrounding you in all directions.

Suddenly you hear a deafening bang.

As your ears begin to clear up you hear a cacophany: sounds of thunder, of yelling and stamping feet.  You hear the sounds of a battlefield.

Another gunshot sounds from incredibly close.  Moments later, you finally see light.

gun barrel
You are in one end of a rifle barrel.  Nearby, the hammer lies still, blocking one end of the barrel.  Out the opening at the other end you can see the face of a twenty-three year old Japanese girl wearing camoflauge.

Next to you is a packed mass of gunpowder.

>take gunpowder
You accidentally ignite the gunpowder!  Somehow.

The mass of gunpowder explodes, and you are sent flying out of the rifle.

Your bedroom
You can see a textbook here.

* * *

Delirium
An Interactive Fiction by Steven Hack and Rhys Larkins
Release 1 / Serial number 130306 / Inform 7 build 6G60 (I6/v6.32 lib 6/12N) SD

Your bedroom
You can see a rifle and a textbook here.

>examine gun
trolololololol
gun barrel

* * *

Delirium
An Interactive Fiction by Steven Hack and Rhys Larkins
Release 1 / Serial number 130306 / Inform 7 build 6G60 (I6/v6.32 lib 6/12N) SD

Your bedroom
You can see a rifle and a textbook here.

>jump gun
I only understood you as far as wanting to jump.

* * *

Delirium
An Interactive Fiction by Steven Hack and Rhys Larkins
Release 1 / Serial number 130306 / Inform 7 build 6G60 (I6/v6.32 lib 6/12N) SD

Your bedroom
You can see a rifle and a textbook here.

>take rifle
You try taking the rifle, but as you approach it you instead find yourself falling...

You are cramped into a tight space with metal surrounding you in all directions.

Suddenly you hear a deafening bang.

As your ears begin to clear up you hear a cacophany: sounds of thunder, of yelling and stamping feet.  You hear the sounds of a battlefield.

Another gunshot sounds from incredibly close.  Moments later, you finally see light.

gun barrel
You are in one end of a rifle barrel.  Nearby, the hammer lies still, blocking one end of the barrel.  Out the opening at the other end you can see the face of a twenty-three year old Japanese girl wearing camoflauge.

Next to you is a packed mass of gunpowder.

>examine face
You can't see any such thing.

* * *

Delirium
An Interactive Fiction by Steven Hack and Rhys Larkins
Release 1 / Serial number 130306 / Inform 7 build 6G60 (I6/v6.32 lib 6/12N) SD

Your bedroom
You can see a rifle and a textbook here.

>kick gun
That's not a verb I recognise.

* * *

Delirium
An Interactive Fiction by Steven Hack and Rhys Larkins
Release 1 / Serial number 130306 / Inform 7 build 6G60 (I6/v6.32 lib 6/12N) SD

Your bedroom
You can see a rifle and a textbook here.

>eat gun
(first taking the rifle)
You try taking the rifle, but as you approach it you instead find yourself falling...

Darkness
It is pitch dark, and you can't see a thing.

You are cramped into a tight space with metal surrounding you in all directions.

Suddenly you hear a deafening bang.

As your ears begin to clear up you hear a cacophany: sounds of thunder, of yelling and stamping feet.  You hear the sounds of a battlefield.

Another gunshot sounds from incredibly close.  Moments later, you finally see light.

gun barrel
You are in one end of a rifle barrel, in a chamber adjacent to a pile of gunpowder.  The hammer lies slack, nearly out of your view.  Out the opening at the other end of the barrel you can see the face of a twenty-three year old Japanese girl wearing camoflouge.

You can see a hammer here.

>showme gunpowder
pile of gunpowder - thing
location: in the gun barrel
singular-named, improper-named; unlit, inedible, fixed in place, scenery
printed name: "pile of gunpowder"
printed plural name: none
indefinite article: none
description: none
initial appearance: none

* * *

Delirium
An Interactive Fiction by Steven Hack and Rhys Larkins
Release 1 / Serial number 130306 / Inform 7 build 6G60 (I6/v6.32 lib 6/12N) SD

Your bedroom
You can see a rifle and a textbook here.

>x gun
You try examining the rifle, but as you approach it you instead find yourself falling...

You are cramped into a tight space with metal surrounding you in all directions.

Suddenly you hear a deafening bang.

As your ears begin to clear up you hear a cacophany: sounds of thunder, of yelling and stamping feet.  You hear the sounds of a battlefield.

Another gunshot sounds from incredibly close.  Moments later, you finally see light.

gun barrel
You are in one end of a rifle barrel.  Nearby, the hammer lies slack, nearly out of your view.  Out the opening at the other end of the barrel you can see the face of a twenty-three year old Japanese girl wearing camoflauge.

Next to you is a packed mass of gunpowder.

* * *

Delirium
An Interactive Fiction by Steven Hack and Rhys Larkins
Release 1 / Serial number 130306 / Inform 7 build 6G60 (I6/v6.32 lib 6/12N) SD

Your bedroom
You can see a rifle and a textbook here.

>x textbook
You start reading the textbook, but it makes no sense and is.. just..... so.......... bo........ring...........................................

library

* * *

Delirium
An Interactive Fiction by Steven Hack and Rhys Larkins
Release 1 / Serial number 130306 / Inform 7 build 6G60 (I6/v6.32 lib 6/12N) SD

Your bedroom
You can see a rifle and a textbook here.

>read book
You start reading the textbook, but it makes no sense and is.. just..... so.......... bo........ring...........................................

library

* * *

Delirium
An Interactive Fiction by Steven Hack and Rhys Larkins
Release 1 / Serial number 130306 / Inform 7 build 6G60 (I6/v6.32 lib 6/12N) SD

Your bedroom
You can see a rifle and a textbook here.

>>>>>>>
That's not a verb I recognise.

><
That's not a verb I recognise.

>:D
That's not a verb I recognise.

>^<v
That's not a verb I recognise.

>.<
That's not a verb I recognise.

><> ><> ><> ><> ><> ><> ><> ><> ><> ><> ><> ><>
That's not a verb I recognise.

>kill gun
You try attacking the rifle, but as you approach it you instead find yourself falling...

You are cramped into a tight, dark space with metal surrounding you in all directions.

Suddenly you hear a deafening bang.

As your ears begin to clear up you hear a cacophany: sounds of thunder, of yelling and stamping feet.  You hear the sounds of a battlefield.

Another gunshot sounds from incredibly close.  Moments later, you finally see light.

gun barrel
You are in one end of a rifle barrel.  Nearby, the hammer lies still, blocking one end of the barrel.  Out the opening at the other end you can see the face of a twenty-three year old Japanese girl wearing camoflauge.

Next to you is a packed mass of gunpowder.

>take powder
You can't see any such thing.

* * *

Delirium
An Interactive Fiction by Steven Hack and Rhys Larkins
Release 1 / Serial number 130306 / Inform 7 build 6G60 (I6/v6.32 lib 6/12N) SD

Your bedroom
You can see a rifle and a textbook here.

>kill gun
You try attacking the rifle, but as you approach it you instead find yourself falling...

You are cramped into a tight, dark space with metal surrounding you in all directions.

Suddenly you hear a deafening bang.

As your ears begin to clear up you hear a cacophany: sounds of thunder, of yelling and stamping feet.  You hear the sounds of a battlefield.

Another gunshot sounds from incredibly close.  Moments later, you finally see light.

gun barrel
You are in one end of a rifle barrel.  Nearby, the hammer lies still, blocking one end of the barrel.  Out the opening at the other end you can see the face of a twenty-three year old Japanese girl wearing camoflauge.

Next to you is a packed mass of gunpowder.

>take powder
You accidentally ignite the gunpowder!  Somehow.

The mass of gunpowder explodes, and you are sent flying out of the rifle.

Your bedroom
You can see a textbook here.

>inv
You are carrying:
  a rifle

* * *

Delirium
An Interactive Fiction by Steven Hack and Rhys Larkins
Release 1 / Serial number 130306 / Inform 7 build 6G60 (I6/v6.32 lib 6/12N) SD

Your bedroom
You can see a rifle and a textbook here.

>light book
This dangerous act would achieve little.

>ignite rifle
That's not a verb I recognise.

>actions
Actions listing on.

>light rifle
[burning the rifle]
You try burning the rifle, but as you approach it you instead find yourself falling...

[burning the rifle - failed]

You are cramped into a tight, dark space with metal surrounding you in all directions.

Suddenly you hear a deafening bang.

As your ears begin to clear up you hear a cacophany: sounds of thunder, of yelling and stamping feet.  You hear the sounds of a battlefield.

Another gunshot sounds from incredibly close.  Moments later, you finally see light.

[looking]
gun barrel
You are in one end of a rifle barrel.  Nearby, the hammer lies still, blocking one end of the barrel.  Out the opening at the other end you can see the face of a twenty-three year old Japanese girl wearing camoflauge.

Next to you is a packed mass of gunpowder.

[looking - succeeded]

>burn powder
[burning the mass of gunpowder]
This dangerous act would achieve little.
[burning the mass of gunpowder - failed the block burning rule]

You hear a click, and the hammer begins to pull away from you.

* * *

Delirium
An Interactive Fiction by Steven Hack and Rhys Larkins
Release 1 / Serial number 130306 / Inform 7 build 6G60 (I6/v6.32 lib 6/12N) SD

Your bedroom
You can see a rifle and a textbook here.

>invent gun
That's not a verb I recognise.

>look gun
You try examining the rifle, but as you approach it you instead find yourself falling...

You are cramped into a tight, dark space with metal surrounding you in all directions.

Suddenly you hear a deafening bang.

As your ears begin to clear up you hear a cacophany: sounds of thunder, of yelling and stamping feet.  You hear the sounds of a battlefield.

Another gunshot sounds from incredibly close.  Moments later, you finally see light.

gun barrel
You are in one end of a rifle barrel.  Nearby, the hammer lies still, blocking one end of the barrel.  Out the opening at the other end you can see the face of a twenty-three year old Japanese girl wearing camoflauge.

Next to you is a packed mass of gunpowder.

>burn powder
The mass of gunpowder explodes, and you are sent flying out of the rifle.

battlefield