Beep! Beep! Beep! Beep!

You wake up in a jolt! It's morning, you think... As you think this, your head is suddenly overcome by a wave of horrible pain. A fever, now of all times?

You were given so much time to prepare to leave home, but you put it off. You procrastinated and wasted time. Then, when you knew it could wait no longer, THEN you decided to start researching, and look where it's left you? You've been trudging through all this research for so long that you've gone and overworked yourself, and earned a fever for it.

You try to light a cigarette, but a wave of nausea overcomes you, and you think better of it.

...Anyway, you have to make a decision soon. There are many paths ahead of you, and only one of them is going to be the one that makes you truly happy. You only have so long til your parents just up and kick you out, so it'd be best to make your decision soon.

Future-Tense Delirium
An Interactive Fiction by Steven Hack and Rhys Larkins
Release 1 / Serial number 130315 / Inform 7 build 6G60 (I6/v6.32 lib 6/12N) SD

Your bedroom
The same old room you've always been in since who knows when. Sigh... you're gonna miss this old place...

You can see a rifle, a textbook and a rent contract here.

>take gun
You try taking the rifle, but as you approach it you instead find yourself falling...

Darkness.
You are cramped into a tight, dark space with metal surrounding you in all directions.

Suddenly you hear a deafening bang.

As your ears begin to clear up you hear a cacophany of other noises: sounds of thunder, sounds of yelling and stamping feet.  You hear the sounds of a battlefield.

Another gunshot sounds from incredibly nearby.  Moments later, you finally see light.

gun barrel
You are in one end of a rifle barrel.  Nearby, the hammer lies still, blocking one end of the barrel.  Out the opening at the other end you can see a twenty-three year old Japanese girl wearing camoflauge and wielding a submachine gun.

Next to you is a packed mass of gunpowder.

You can also see a barrel opening here.

>take gunpowder
You accidentally ignite the gunpowder!  Somehow.

The mass of gunpowder explodes, and you are sent flying out of the rifle.

Your bedroom
You can see a textbook here.

>inv
You are carrying:
  a rifle

* * *

>light powder
The mass of gunpowder explodes, and you are sent flying out of the rifle.

battlefield
A Japanese girl lies here, a bullet through her heart.

You can also see a Japanese man here.

>drop gun
(the rifle)
Dropped.

>take gun
(the rifle)
Taken.

>scenes
Scene 'Entire Game' playing (for 4 mins now)
Scene 'Both Sides of the Gun' playing (for 4 mins now)
(Scene monitoring now switched on. Type "scenes off" to switch it off again.)

* * *

>examine gun
trolololololol
gun barrel

* * *

>jump gun
I only understood you as far as wanting to jump.

>jump shark
I only understood you as far as wanting to jump.

>kill gun
You try attacking the gun, but as you approach it you find yourself falling into the barrel.

gun barrel

* * *

>take rifle
You try taking the rifle, but as you approach it you instead find yourself falling...

You are cramped into a tight, dark space with metal surrounding you in all directions.

Suddenly you hear a deafening bang.

As your ears begin to clear up you hear a cacophany: sounds of thunder, of yelling and stamping feet.  You hear the sounds of a battlefield.

Another gunshot sounds from incredibly close.  Moments later, you finally see light.

gun barrel
You are in one end of a rifle barrel.  Nearby, the hammer lies still, blocking one end of the barrel.  Out the opening at the other end you can see a twenty-three year old Japanese Japanese girl wearing camoflauge and wielding a submachine gun.

Next to you is a packed mass of gunpowder.

>examine face
You can't see any such thing.

>wait
Time passes.

You hear a click, and the hammer begins to pull away from you.

>wait
Time passes.

* * *

>examine face
You can't see any such thing.

>examine gunpowder
You see nothing special about the mass of gunpowder.

You hear a click, and the hammer begins to pull away from you.

>x hammer
You see nothing special about the hammer.

* * *

>kick gun
That's not a verb I recognise.

>take gun
You try taking the rifle, but as you approach it you instead find yourself falling...

gun barrel
This is a room description.

This is a scene beginning text.

* * *

>kick gun
That's not a verb I recognise.

>eat gun
(first taking the rifle)
You try taking the rifle, but as you approach it you instead find yourself falling...

You are cramped into a tight space with metal surrounding you in all directions.

Suddenly you hear a deafening bang.

As your ears begin to clear up you hear a cacophany: sounds of thunder, of yelling and stamping feet.  You hear the sounds of a battlefield.

Another gunshot sounds from incredibly close.  Moments later, you finally see light.

>look
gun barrel
You are in one end of a rifle barrel.  Nearby, the hammer lies slack, nearly out of your view.  Out the opening at the other end of the barrel you can see the face of a twenty-three year old Japanese girl wearing camoflauge.

Next to you is a packed mass of gunpowder.

* * *

>eat gun
(first taking the rifle)
You try taking the rifle, but as you approach it you instead find yourself falling...

You are cramped into a tight, dark space with metal surrounding you in all directions.

Suddenly you hear a deafening bang.

As your ears begin to clear up you hear a cacophany: sounds of thunder, of yelling and stamping feet.  You hear the sounds of a battlefield.

Another gunshot sounds from incredibly close.  Moments later, you finally see light.

gun barrel
You are in one end of a rifle barrel.  Nearby, the hammer lies still, blocking one end of the barrel.  Out the opening at the other end you can see the face of a twenty-three year old Japanese girl wearing camoflauge.

Next to you is a packed mass of gunpowder.

>showme gunpowder
pile of gunpowder - thing
location: in the gun barrel
singular-named, improper-named; unlit, inedible, fixed in place, scenery
printed name: "pile of gunpowder"
printed plural name: none
indefinite article: none
description: none
initial appearance: none

* * *

>take powder
You take the gunpowder, removing it from its place at the hammer's base.

You hear a click, and the hammer begins to pull away from you.

>dance
That's not a verb I recognise.

>jump
You jump on the spot, fruitlessly.

The hammer springs forward and sparks.

>look out
You see nothing unexpected in that direction.

>look
gun barrel
You are in one end of a rifle barrel.  Nearby, the hammer lies still, blocking one end of the barrel.  Out the opening at the other end you can see the face of a twenty-three year old Japanese girl wearing camoflauge.

>jump
You jump on the spot, fruitlessly.

>wait
Time passes.

* * *

>x gun
You try examining the rifle, but as you approach it you instead find yourself falling...

Darkness.
You are cramped into a tight, dark space with metal surrounding you in all directions.

Suddenly you hear a deafening bang.

As your ears clear up you hear a cacophany of other noises: thunderous rat-a-tat-a-tats, stamping feet, the occasional yell.  The sounds of a battlefield.

Another gunshot sounds from incredibly nearby.  Moments later, you finally see light.

gun barrel
You are in one end of a rifle barrel.  Nearby, the hammer lies still, blocking one end of the barrel.  Out the opening at the other end you can see a twenty-three year old Japanese girl wearing camouflage and wielding a submachine gun.

Next to you is a packed mass of gunpowder.

You can also see a barrel opening here.

>take powder
You take the gunpowder, removing it from its place at the hammer's base.

>wait
Time passes.

You hear a click, and the hammer begins to pull away from you.

At the same time, the Japanese girl raises her gun, pointing it at whoever's holding the gun you're in.

>out
You can't seem to move very far.  Almost like you don't have legs.

The hammer springs forward and sparks.
However, the spark fails to light anything.

>wait
Time passes.

The girl begins firing, and you feel a sense of vertigo as the rifle tilts upwards...

battlefield
Your comrade Jenkins lies fallen here, riddled with bullets.

You can also see a twenty-three year old Japanese girl here.

>look
battlefield
Your comrade Jenkins lies fallen here, riddled with bullets.

You can also see a twenty-three year old Japanese girl here.

>shoot girl
you shoot the twenty-three year old Japanese girl
Your bedroom
You can see a textbook here.

>inv
You are carrying:
  a rifle
  a mass of gunpowder
  a lighter

* * *

>look opening
You see nothing special about the barrel opening.

* * *

>x camo
You see nothing special about the camoflauge.

>x gun
You see nothing special about the submachine gun.

You hear a click, and the hammer begins to pull away from you.

At the same time, the Japanese girl raises her gun, pointing it at whoever's holding the gun you're in.

>x girl
You see nothing special about the twenty-three year old Japanese girl.

The hammer springs forward and sparks.

The mass of gunpowder explodes, and you are sent flying out of the rifle.

battlefield
A Japanese girl lies here, a bullet through her heart.

You can also see a Japanese man here.

>score
There is no score in this story.

Military: 0
College: 0
Moving: 0

>look
battlefield
A Japanese girl lies here, a bullet through her heart.

You can also see a Japanese man here.

>shoot man
you shoot the Japanese man.

Suddenly, you are back in
Your bedroom
You can see a medal, a textbook and a rent contract here.

>score
There is no score in this story.

Military: 4
College: 0
Moving: 0

>x comtract
You can't see any such thing.

>x contract
You try to understand the legal-ese that the contract was written in, becoming absorbed in trying to understand it all. Soon, you feel as if you've lost track of time and place in trying to understand this ridiculous wording...

real estate office
You find yourself in an office of a real estate agent. In front of you, on a desk, is a pen, and that rent contract.

After having spent considerable time looking through properties, you think you've found the right one. Comfortably near all the major businesses; Decently priced; Has all the amenities you'll need. It almost feels too good to be true.

You can see a real estate agent here.

* * *

>x powder
Now is a time for action, not careful examination!

>x powder
Now is a time for action, not careful examination!

You hear a click, and the hammer begins to pull away from you.

At the same time, the Japanese girl raises her gun, pointing it at whoever's holding the gun you're in.

>examine powder
Now is a time for action, not careful examination!

The hammer springs forward and sparks.

The mass of gunpowder explodes, and you are sent flying out of the rifle.

battlefield
For what little time you have to look around, all you see is a large, treeless wasteland. You can hear gunshots coming from seemingly every direction.

A Japanese man stands here with a submachine gun, not having noticed you yet.

The Japanese girl lies here, a bullet from your rifle through her heart.

You ready your rifle and prepare for the fray.

>look
battlefield
For what little time you have to look around, all you see is a large, treeless wasteland. You can hear gunshots coming from seemingly every direction.

A Japanese man stands here with a submachine gun, not having noticed you yet.

The Japanese girl lies here, a bullet from your rifle through her heart.

>shoot man
Like a good soldier, you shoot the Japanese man.

The moment the corpse of a Japanese man falls to the ground, you suddenly start to feel faint, and fall to the ground.

As your consciousness fades, you only feel relief that you've brought this whole conflict one step closer to victory, that you've done one more thing to keep your friends and family safe, and one more thing in service to your country.

Suddenly, you open your eyes again. It was all just a dream; A product of your high fever. You are back in
Your bedroom
The same old room you've always been in since who knows when. Sigh... you're gonna miss this old place...

You can see a textbook and a rent contract here.

* * *

>x textbook
You start reading the textbook, but it makes no sense and is.. just..... so.......... bo........ring...........................................

library

* * *

>read book
You start reading the textbook, but it makes no sense and is.. just..... so.......... bo........ring...........................................

library

* * *

>kill gun
You try attacking the rifle, but as you approach it you instead find yourself falling...

Darkness.
You are cramped into a tight, dark space with metal surrounding you in all directions.

Suddenly you hear a deafening bang.

As your ears begin to clear up you hear a cacophany of other noises: sounds of thunder, sounds of yelling and stamping feet.  You hear the sounds of a battlefield.

Another gunshot sounds from incredibly nearby.  Moments later, you finally see light.

gun barrel
You are in one end of a rifle barrel.  Nearby, the hammer lies still, blocking one end of the barrel.  Out the opening at the other end you can see a twenty-three year old Japanese girl wearing camoflauge and wielding a submachine gun.

Next to you is a packed mass of gunpowder.

You can also see a barrel opening here.

>take powder
You take the gunpowder, removing it from its place at the hammer's base.

>inv
You are carrying:
  a rifle

>read book
You start reading the textbook, but it makes no sense and is.. just..... so.......... bo........ring...........................................

library

>death
That's not a verb I recognise.

>die
That's not a verb I recognise.

>kill self
Violence isn't the answer to this one.

>shoot self
That's not a verb I recognise.

* * *

>take powder
You take the gunpowder, removing it from its place at the hammer's base.

>look hammer
You see nothing special about the hammer.

You hear a click, and the hammer begins to pull away from you.

>x out
Outside the barrel, you can see only a Japanese girl.

You see nothing special about the twenty-three year old Japanese girl.

The hammer springs forward and sparks.
However, the spark fails to light anything.
 The girl raises her gun, pointing it at whoever's holding the gun you're in.

>eat powder
That's plainly inedible.

you got shot
battlefield
Your comrade Jenkins lies fallen here, riddled with bullets.

You can also see a twenty-three year old Japanese girl here.

* * *

>look out
Outside the barrel, you can see only a Japanese girl.

You see nothing special about the twenty-three year old Japanese girl.

You hear a click, and the hammer begins to pull away from you.

>out
battlefield
You can see a Japanese girl here.

>look
battlefield
You can see a Japanese girl here.

>in
gun barrel
You are in one end of a rifle barrel.  Nearby, the hammer lies still, blocking one end of the barrel.  Out the opening at the other end you can see a twenty-three year old Japanese Japanese girl wearing camoflauge and wielding a submachine gun.

Next to you is a packed mass of gunpowder.

>look out
You see nothing unexpected in that direction.

>x out
You see nothing unexpected in that direction.

* * *

>look out
Outside the barrel, you can see only a Japanese girl.

You see nothing special about the twenty-three year old Japanese girl.

You hear a click, and the hammer begins to pull away from you.

>kill japanese girl
You can't reach into the battlefield.

The hammer springs forward and sparks.

The mass of gunpowder explodes, and you are sent flying out of the rifle.

battlefield
You can see a twenty-three year old Japanese girl here.

* * *

>out
You can't seem to move very far.  Almost like you don't have legs.

>x girl
You see nothing special about the twenty-three year old Japanese girl.

>x girl's corps
I only understood you as far as wanting to examine the twenty-three year old Japanese girl's body.

>x girl's corpse
I only understood you as far as wanting to examine the twenty-three year old Japanese girl's body.

>in
gun barrel
You are in one end of a rifle barrel.  Nearby, the hammer lies still, blocking one end of the barrel.  Out the opening at the other end you can see a twenty-three year old Japanese girl wearing camoflauge and wielding a submachine gun.

Next to you is a packed mass of gunpowder.

The hammer springs forward and sparks.

The mass of gunpowder explodes, and you are sent flying out of the rifle.

battlefield
You can see a twenty-three year old Japanese girl here.

>x corpse
*** Run-time problem P12: Too many activities are going on at once.

* * *

>in
gun barrel
You are in one end of a rifle barrel.  Nearby, the hammer lies still, blocking one end of the barrel.  Out the opening at the other end you can see a twenty-three year old Japanese girl wearing camoflauge and wielding a submachine gun.

Next to you is a packed mass of gunpowder.

The hammer springs forward and sparks.

The mass of gunpowder explodes, and you are sent flying out of the rifle.

battlefield
You can see a twenty-three year old Japanese girl here.

>x girl's corpse
*** Run-time problem P12: Too many activities are going on at once.

* * *

>in
gun barrel
You are in one end of a rifle barrel.  Nearby, the hammer lies still, blocking one end of the barrel.  Out the opening at the other end you can see a twenty-three year old Japanese girl wearing camoflauge and wielding a submachine gun.

Next to you is a packed mass of gunpowder.

The hammer springs forward and sparks.

The mass of gunpowder explodes, and you are sent flying out of the rifle.

battlefield
You can see a twenty-three year old Japanese girl here.

>x corps
You can't see any such thing.

>x corpse
You see nothing special about the twenty-three year old Japanese girl.

* * *

>out
You can't seem to move very far.  Almost like you don't have legs.

>showme girl
twenty-three year old Japanese girl - person
    twenty-three year old Japanese girl's body (part of twenty-three year old Japanese girl) - body
    camoflauge (worn)
    submachine gun
location: in the battlefield
singular-named, improper-named; unlit, inedible, portable; male, alive
printed name: "twenty-three year old Japanese girl"
printed plural name: "people"
indefinite article: none
description: none
initial appearance: none
carrying capacity: 100

* * *

>out
You can't seem to move very far.  Almost like you don't have legs.

>sout
That's not a verb I recognise.

>south
You can't seem to move very far.  Almost like you don't have legs.

You hear a click, and the hammer begins to pull away from you.
 At the same time, the Japanese girl raises her gun, pointing it at whoever's holding the gun you're in.

* * *

>out
You can't seem to move very far.  Almost like you don't have legs.

>x opening
You see nothing special about the barrel opening.

You hear a click, and the hammer begins to pull away from you.
 At the same time, the Japanese girl raises her gun, pointing it at whoever's holding the gun you're in.

* * *

>dance
That's not a verb I recognise.

>jump
You jump on the spot, fruitlessly.

>take powder
You take the gunpowder, removing it from its place at the hammer's base.

You hear a click, and the hammer begins to pull away from you.

At the same time, the Japanese girl raises her gun, pointing it at whoever's holding the gun you're in.

>drop powder
Dropped.

The hammer springs forward and sparks.

The mass of gunpowder explodes, and you are sent flying out of the rifle.

battlefield
You can see a the corpse of twenty-three year old Japanese girl here.

>durrrrrrrrrrrrrrr
That's not a verb I recognise.

>take self
You are always self-possessed.

>x camo
You can't see any such thing.

>x camoflauge
You see nothing special about camoflauge.

>shoot enemy
That's not a verb I recognise.

* * *

>light powder
The mass of gunpowder explodes, and you are sent flying out of the rifle.

battlefield
A Japanese girl lies here, a bullet through her heart.

>burn girl
This dangerous act would achieve little.

>burn everything
You can't use multiple objects with that verb.

>take everything
submachine gun: That seems to belong to the the corpse of twenty-three year old Japanese girl.

>inv
You are carrying:
  a rifle
  a lighter